filename, language, Rust, YAML, comment, blank, total
.github\workflows\rust.yml, YAML, 0, 11, 0, 5, 16
build.rs, Rust, 4, 0, 1, 2, 7
src\ast\mod.rs, Rust, 545, 0, 37, 57, 639
src\bytevec\errors.rs, Rust, 66, 0, 0, 8, 74
src\bytevec\impls\collections.rs, Rust, 422, 0, 3, 37, 462
src\bytevec\impls\mod.rs, Rust, 33, 0, 7, 7, 47
src\bytevec\impls\primitives.rs, Rust, 115, 0, 0, 12, 127
src\bytevec\macros.rs, Rust, 121, 0, 76, 11, 208
src\bytevec\mod.rs, Rust, 9, 0, 135, 2, 146
src\bytevec\traits.rs, Rust, 21, 0, 7, 2, 30
src\index\btree.rs, Rust, 105, 0, 0, 9, 114
src\index\in_file.rs, Rust, 71, 0, 27, 14, 112
src\index\mod.rs, Rust, 2, 0, 0, 0, 2
src\index\tmp.rs, Rust, 285, 0, 124, 29, 438
src\main.rs, Rust, 26, 0, 16, 13, 55
src\parser\lrsql.rs, Rust, 203232, 0, 2, 2283, 205517
src\parser\mod.rs, Rust, 1, 0, 20, 6, 27
src\rm\file_handler.rs, Rust, 132, 0, 10, 15, 157
src\rm\filesystem\bufmanager\buf_page_manager.rs, Rust, 152, 0, 48, 29, 229
src\rm\filesystem\bufmanager\find_replace.rs, Rust, 29, 0, 0, 7, 36
src\rm\filesystem\bufmanager\mod.rs, Rust, 2, 0, 0, 0, 2
src\rm\filesystem\fileio\file_manager.rs, Rust, 84, 0, 0, 20, 104
src\rm\filesystem\fileio\file_table.rs, Rust, 0, 0, 0, 1, 1
src\rm\filesystem\fileio\mod.rs, Rust, 2, 0, 0, 1, 3
src\rm\filesystem\mod.rs, Rust, 4, 0, 0, 0, 4
src\rm\filesystem\pagedef.rs, Rust, 4, 0, 2, 0, 6
src\rm\filesystem\utils\bitmap.rs, Rust, 150, 0, 32, 29, 211
src\rm\filesystem\utils\hashmap.rs, Rust, 63, 0, 0, 12, 75
src\rm\filesystem\utils\linklist.rs, Rust, 80, 0, 1, 16, 97
src\rm\filesystem\utils\mod.rs, Rust, 3, 0, 0, 1, 4
src\rm\in_file.rs, Rust, 156, 0, 36, 12, 204
src\rm\mod.rs, Rust, 7, 0, 0, 0, 7
src\rm\pagedef.rs, Rust, 46, 0, 0, 11, 57
src\rm\record.rs, Rust, 47, 0, 0, 6, 53
src\rm\record_manager.rs, Rust, 133, 0, 0, 21, 154
src\rm\table_handler.rs, Rust, 53, 0, 4, 14, 71
src\settings.rs, Rust, 21, 0, 2, 3, 26
src\sql.rs, Rust, 46, 0, 4, 7, 57
src\tok\mod.rs, Rust, 750, 0, 18, 35, 803
src\utils\bit.rs, Rust, 68, 0, 0, 19, 87
src\utils\file.rs, Rust, 22, 0, 0, 7, 29
src\utils\macro.rs, Rust, 10, 0, 0, 0, 10
src\utils\mod.rs, Rust, 4, 0, 0, 0, 4
src\utils\random.rs, Rust, 70, 0, 0, 9, 79
src\utils\string.rs, Rust, 19, 0, 0, 4, 23
Total, -, 207215, 11, 612, 2776, 210614